                                      11111111111111111
                                  1111111100001000111111111
                              11111100000000001000000000011111
                            1111000000000010001000000000000011111
                          11110000001111111000100011111100000001111
                        11100000011111100000001000000111111100000111
                      111000001111100000000000100000000000111110000111
                     111000011110000000111111111111110000000011110000111
                   111000011110000011111111110011111111110000001111000011
                  111000111000001111100000000000000000011111000001110000111
                 11000011100001111000000000011100000000000111110000111000111
               11100011100001110000000111111111111111110000001111000011000011
              1110001110001110000011111110000010000011111100000111000011100011
             111000110000110000011110000000000100000000011111000011100011100011
            11100111000111000011110000000110001000110000000111100001100001100011
            110011100011000011100000011111100010001111110000011100001110001100011
           11001110001100011100000111110000000100000001111100001110001110001100011
          1100011000110001110000111100000000011000000000011110000110000110001100011
         11000110001100011000011100000011111111111111000000111100011100011000110011
        1100011000110001100011100000111111000000001111110000011100001100011000110011
        11001100011000110001110000111100000000000000001111100001110001100011001100011
       1100110001100011000110000111000000011111111000000011110001110001100011001100011
      11000110011000110001100011100000111111111111111100000111000011000110011000110011
      110011001100011000110001110000111100000010000011111000011100011000110011000110011
     1100110001000110001100011000011100000000010000000011110001110001100011001100110011
     11001100110011000110001100011100000011000100011000001110001110001100110001100110011
    110011001100011001100011000111000011111000100011110000011100011000110011001100110011
    1100110011001100110001100011000011110000001000000111100011100011001100011001100110011
   11001100110011000100011000110001110000000111110000001110000110001100110011001100110011
   11001100110011001100110001100011100001111111111110000011100011001100011001100110011001
   100010011001100110001000110001100001111000000001111100011100011001100110011001100110011
  1100110011001100110011001100011000111000000000000001110000110011000110011001100110010011
  1100110010011001100110001000110001110000111111110000011100111001100110011001100110011001
  10001001100110011001100110011000110000111111111111100011100110001100110011001000100110011
  10011001100100010011001100110001100011100000100001110001110011001100110011001100110010011
 110011001001100110011001100110011000111000000100000011100110001100110011001000100110011001
 1100100110011001000100110011001100011000000001000100011100110011001100110011001000100110011
 1000100110010001001100110011001100110001110001000110001100011001100110010011001100100110011
 1001100110010011001100100010011001100011000001000011100110011001100110011001001100110010011
 1001100100110011001001100110011001100110000111110001100011001100100010011001000100110010011
11001100100110010001001100110010011001100011111111000110011001100110010011001100100110011001
11001000100110010011001100100110011001100110000001100011001000100110011001001100100110011001
11001000000110010000001001100000010011001100000000110011000000100110000001001100000010011001
11001000000110010000001001100000010011001100000000011001000000110010000001001100000010011001
11001000000100110000001001100000110011001000000000011001100000110010000001000100000010011001
11001111111100111111111001111111110011001000000000011001111111110011111111100111111110011001
11001111111100111111111001111111110010001000000000011001101111110011111111000111111110011001
11001000000110010000001001100000110011001000000000011001000000110010000001001100000010011001
11001000000110010000001001100000010011001100000000010001000000110010000001001100000010011001
11001000100110010011001000100010010001000110000000110011001000100110011001001100100010011001
11001100100110010011001100100110011001100111000001100011001000100110010001001100100110011001
11001100100110011001001100110010001000110001110011000110011001100110010011001100100110010011
 1001100100110011001000100110011001100111000110010001100010001000100110011001001100110010011
 1001100110010011001100110010001000110011100110010001000110011001100110010001001100110010011
 1100100110011001001100110011001100111000100110010000001100010001100100110011001100100110011
 110010011001100110010001000100011001100010011001000001100011001100110011001100100110011001 
 110011001000100110011001100110011000000010011001000111000110001000110010001001100110011001 
  10011001100110010001000100011001100000010011001011110001100011001100110011001100100010011 
  11001001100110011001100110011000111000010011001111000011000110001000110010001000100110011 
  1100110010001000100010001100110001110001001100100000111000110001100110011001100110011001  
   100110011001100110011001100011000011101001100100011110001100011001100010001000100010011  
   110010001000100010001100110001110000111001100100011000011000110001100110011001100110011  
   11001100110011001100110001100011100000100110010000000111000110001100010001100110010001   
    1000100010001000110011000110000111000100110010000011110001100011000110011001100110011   
    1100110011001100011001100011100001000100110010001111000011000110001100110001000110011   
     10001000110011001100011000111000000010011001111110000111000111001100011001100110011    
     11001100110001100110001100001110000010011001100000011110001100011000110001000110011    
      100011001100110001100011100001110001001100000000111100001100011100110001100110011     
      11001100011001100011000111000001111100110000111111000011100011100110001100110001      
       1000110011000110001110001110000001100111111111000001111000110001110011000110011      
       110001100110001100011100001110000000011000000000011110000110001110011000110011       
        11001100011000110000110000011110000011000000011111000011100011100011001100011       
         110011000110001100001110000011111111100111111100000011100011000011001100011        
         11000110001100011100001110000000111110011110000001111000011000111001110011        
          110001100011000011000001111000000011001000000011110000111000111000110011        
           11000110001110001110000011111100011001000111111000011110001100011100111        
            110001100011100001110000001111001100100011100000011100001100011100011        
             1100011000011100001110000000100110010000000001111000011100011100011        
              11000111000111000001111100010011001000000111110000011000011100011        
               110001110000111000001110001001100111111111000000111000011000111        
                1100001100000111000000000100110011111000000011110000111000111        
                 11000011100000111100000010011001000000001111100001110000111        
                  11100001110000011111100100110010000111111000000111000011        
                    11000001110000001111110011001000111100000011110000111        
                     11100000111100000000100110010000000000011110000111        
                       11100000111110000010011001000000011111100000111        
                         1110000001111000100110010011111111000001111        
                           111000000000001001100111111100000001111        
                             11110000000010011000000000000011111        
                               111111100010011000000000111111        
                                   1111111001111111111111
                                        110011111111
                                        100000000001
                                        10000000W001
                                        100000000001
                                        111111111111