     111111111111111111111111
11111100000000000000000000001
10000000000000000000000111111
1000000000000000000000000000111111111
1111111100000000111111000000000000001
       1000000001    1000N00000000001
       1000000001   1000000111111111
       1000000001111110000001
11111111000000000000000001001
10000000000000000000001111111
1000001111111000000001
1000001     100000001       1111111
1000001     100000001       1000001
1111111     111111111        11111