EA ./assets/textures/walls/stone_bricks/2.xpm

SO ./assets/textures/walls/stone_bricks/2.xpm

NO ./assets/textures/walls/stone_bricks/2.xpm

WE ./assets/textures/walls/stone_bricks/2.xpm

S ./assets/sprites/barrel.xpm

R 1920 1080
F ./assets/textures/floor/sand.xpm
C ./assets/sky/mountains/mountains.xpm

 111111111111111111111111111         
10000000000100000000000000001
100200000002000000W0000110111
100000000001000000000000000001111111
 111111000000000111111000000000000001
       1002002001   1000000000000001
       1000000001   1000000111111111
       10002000011110000000001
 1111110000000000000000000001
1000000000002000100000111111
1000000111110000000001
1000001     100000001       1111111
1002001     100000001       1000001
 11111       1111111         11111