     11111111111111111111111
 1111000000000000000000000001
10000000002000000000000110111
100000000000000000000000000001111111
 111111000000000111111000000000000001
       1000000001   1000N00000020001
       1000002001   1000000111111111
       10000000011110000000001
 1111110000000000000000000001
1000000000000000100000111111
1000000111110000000001
1020001     100000001       1111111
1000001     100000001       1000001
 11111       1111111         11111