EA ./assets/textures/walls/stone_bricks/2.xpm

SO ./assets/textures/walls/stone_bricks/2.xpm

NO ./assets/textures/walls/stone_bricks/2.xpm

WE ./assets/textures/walls/stone_bricks/2.xpm

S ./assets/textures/walls/stone_bricks/2.xpm

R 1920 1080
F ./assets/textures/floor/sand.xpm
C ./assets/sky/mountains/mountains.xpm

     11111111111111111111111
 1111000000000000000000000001
100000000000000002000000W0111
100000000000000000000200000001111111
 111111000000000111111000000000000001
       1000000001   1000000000000001
       1000000001   1000000111111111
       10000000011110000000001
 1111110000000000000000000001
1000000000002000100000111111
1000000111110000000001
1000001     102000001       1111111
1000001     100000001       1000001
 11111       1111111         11111