EA ./assets/textures/walls/stone_bricks/2.xpm

SO ./assets/textures/walls/stone_bricks/2.xpm

NO ./assets/textures/walls/stone_bricks/2.xpm

WE ./assets/textures/walls/stone_bricks/2.xpm

S ./assets/sprites/barrel.xpm

R 900 900
F ./assets/textures/floor/sand.xpm
C ./assets/sky/mountains/mountains.xpm

      111
     14S41
    1000001
    1000001
    1000001
    1300031
     14041
     10001
     12021
     10001
 111114041111111111111111111
10000000000000000000000000001
10040000000000000000000000111
100000000000000000000000000001111111
 111000000000000111111000000000000001
    1000000000001   1000000000000001
    1000000000001   1000000111111111
    100000000000011110000000001
 11100000000000000000000000011
1000000000000000100000111111
1000000111110000000001
1000001     100000001       1111111
1000001     100000001       1000001
 11111       1111111         11111