1111111111111111111111111111111111111111111111111111111111111111111111111111111111111111111111111111
1000000000000000000000000000000000000000000000000000000000000000000000000000000000000000000000000001
1000000000000000000000000000000000000000000000000000000000000000000000000000000000000000000000000001
1000000000000000000000000000000000000000000000000000000000000000000000000000000000000000000000000001
1000000000000000000000000000000000000000001111111111111111100000000000000000000000000000000000000001
1000000000000000000000000000000000000011111111000010001111111110000000000000000000000000000000000001
1000000000000000000000000000000000111111000000000010000000000111110000000000000000000000000000000001
1000000000000000000000000000000011110000000000100010000000000000111110000000000000000000000000000001
1000000000000000000000000000001111000000111111100010001111110000000111100000000000000000000000000001
1000000000000000000000000000111000000111111000000010000001111111000001111000000000000000000000000001
1000000000000000000000000011100000111110000000000010000000000011111000011100000000000000000000000001
1000000000000000000000000111000011110000000111111111111110000000011110000111000000000000000000000001
1000000000000000000000011100001111000001111111111001111111111000000111100001100000000000000000000001
1000000000000000000000111000111000001111100000000000000000011111000001110000111000000000000000000001
1000000000000000000001100001110000111100000000001110000000000011111000011100011100000000000000000001
1000000000000000000111000111000011100000001111111111111111100000011110000110000110000000000000000001
1000000000000000001110001110001110000011111110000010000011111100000111000011100011000000000000000001
1000000000000000011100011000011000001111000000000010000000001111100001110001110001100000000000000001
1000000000000000111001110001110000111100000001100010001100000001111000011000011000110000000000000001
1000000000000000110011100011000011100000011111100010001111110000011100001110001100011000000000000001
1000000000000001100111000110001110000011111000000010000000111110000111000111000110001100000000000001
1000000000000011000110001100011100001111000000000110000000000111100001100001100011000110000000000001
1000000000000110001100011000110000111000000111111111111110000001111000111000110001100110000000000001
1000000000001100011000110001100011100000111111000000001111110000011100001100011000110011000000000001
1000000000001100110001100011000111000011110000000000000000111110000111000110001100110001100000000001
1000000000011001100011000110001100001110000000111111110000000111100011100011000110011000110000000001
1000000000110001100110001100011000111000001111111111111111000001110000110001100110001100110000000001
1000000000110011001100011000110001110000111100000010000011111000011100011000110011000110011000000001
1000000001100110001000110001100011000011100000000010000000011110001110001100011001100110011000000001
1000000001100110011001100011000110001110000001100010001100000111000111000110011000110011001100000001
1000000011001100110001100110001100011100001111100010001111000001110001100011001100110011001100000001
1000000011001100110011001100011000110000111100000010000001111000111000110011000110011001100110000001
1000000110011001100110001000110001100011100000001111100000011100001100011001100110011001100110000001
1000000110011001100110011001100011000111000011111111111100000111000110011000110011001100110010000001
1000000100010011001100110001000110001100001111000000001111100011100011001100110011001100110011000001
1000001100110011001100110011001100011000111000000000000001110000110011000110011001100110010011000001
1000001100110010011001100110001000110001110000111111110000011100111001100110011001100110011001000001
1000001000100110011001100110011001100011000011111111111110001110011000110011001100100010011001100001
1000001001100110010001001100110011000110001110000010000111000111001100110011001100110011001001100001
1000011001100100110011001100110011001100011100000010000001110011000110011001100100010011001100100001
1000011001001100110010001001100110011000110000000010001000111001100110011001100110010001001100110001
1000010001001100100010011001100110011001100011100010001100011000110011001100100110011001001100110001
1000010011001100100110011001000100110011000110000010000111001100110011001100110010011001100100110001
1000010011001001100110010011001100110011001100001111100011000110011001000100110010001001100100110001
1000110011001001100100010011001100100110011000111111110001100110011001100100110011001001100110010001
1000110010001001100100110011001001100110011001100000011000110010001001100110010011001001100110010001
1000110010000001100100000010011000000100110011000000001100110000001001100000010011000000100110010001
1000110010000001100100000010011000000100110011000000000110010000001100100000010011000000100110010001
1000110010000001001100000010011000001100110010000000000110011000001100100000010001000000100110010001
1000110011111111001111111110011111111100110010000000000110011111111100111111111001111111100110010001
1000110011111111001111111110011111111100100010000000000110011011111100111111110001111111100110010001
1000110010000001100100000010011000001100110010000000000110010000001100100000010011000000100110010001
1000110010000001100100000010011000000100110011000000000100010000001100100000010011000000100110010001
1000110010001001100100110010001000100100010001100000001100110010001001100110010011001000100110010001
1000110011001001100100110011001001100110011001110000011000110010001001100100010011001001100110010001
1000110011001001100110010011001100100010001100011100110001100110011001100100110011001001100100110001
1000010011001001100110010001001100110011001110001100100011000100010001001100110010011001100100110001
1000010011001100100110011001100100010001100111001100100010001100110011001100100010011001100100110001
1000011001001100110010011001100110011001110001001100100000011000100011001001100110011001001100110001
1000011001001100110011001000100010001100110001001100100000110001100110011001100110010011001100100001
1000011001100100010011001100110011001100000001001100100011100011000100011001000100110011001100100001
1000001001100110011001000100010001100110000001001100101111000110001100110011001100110010001001100001
1000001100100110011001100110011001100011100001001100111100001100011000100011001000100010011001100001
1000001100110010001000100010001100110001110001001100100000111000110001100110011001100110011001000001
1000000100110011001100110011001100011000011101001100100011110001100011001100010001000100010011000001
1000000110010001000100010001100110001110000111001100100011000011000110001100110011001100110011000001
1000000110011001100110011001100011000111000001001100100000001110001100011000100011001100100010000001
1000000010001000100010001100110001100001110001001100100000111100011000110001100110011001100110000001
1000000011001100110011000110011000111000010001001100100011110000110001100011001100010001100110000001
1000000001000100011001100110001100011100000001001100111111000011100011100110001100110011001100000001
1000000001100110011000110011000110000111000001001100110000001111000110001100011000100011001100000001
1000000000100011001100110001100011100001110001001100000000111100001100011100110001100110011000000001
1000000000110011000110011000110001110000011111001100001111110000111000111001100011001100010000000001
1000000000010001100110001100011100011100000011001111111110000011110001100011100110001100110000000001
1000000000011000110011000110001110000111000000001100000000001111000011000111001100011001100000000001
1000000000001100110001100011000011000001111000001100000001111100001110001110001100110001100000000001
1000000000000110011000110001100001110000011111111100111111100000011100011000011001100011000000000001
1000000000000110001100011000111000011100000001111100111100000011110000110001110011100110000000000001
1000000000000011000110001100001100000111100000001100100000001111000011100011100011001100000000000001
1000000000000001100011000111000111000001111110001100100011111100001111000110001110011100000000000001
1000000000000000110001100011100001110000001111001100100011100000011100001100011100011000000000000001
1000000000000000011000110000111000011100000001001100100000000011110000111000111000110000000000000001
1000000000000000001100011100011100000111110001001100100000011111000001100001110001100000000000000001
1000000000000000000110001110000111000001110001001100111111111000000111000011000111000000000000000001
1000000000000000000011000011000001110000000001001100111110000000111100001110001110000000000000000001
1000000000000000000001100001110000011110000001001100100000000111110000111000011100000000000000000001
1000000000000000000000111000011100000111111001001100100001111110000001110000110000000000000000000001
1000000000000000000000001100000111000000111111001100100011110000001111000011100000000000000000000001
1000000000000000000000000111000001111000000001001100100000000000111100001110000000000000000000000001
1000000000000000000000000001110000011111000001001100100000001111110000011100000000000000000000000001
1000000000000000000000000000011100000011110001001100100111111110000011110000000000000000000000000001
1000000000000000000000000000000111000000000001001100111111100000001111000000000000000000000000000001
1000000000000000000000000000000001111000000001001100000000000001111100000000000000000000000000000001
1000000000000000000000000000000000011111110001001100000000011111100000000000000000000000000000000001
1000000000000000000000000000000000000001111111001111111111111100000000000000000000000000000000000001
1000000000000000000000000000000000000000000011001111111100000000000000000000000000000000000000000001
1000000000000000000000000000000000000000000000000000000000000000000000000000000000000000000000000001
1000000000000000000000000000000000000000000000N00000000000000000000000000000000000000000000000000001
1000000000000000000000000000000000000000000000000000000000000000000000000000000000000000000000000001
1111111111111111111111111111111111111111111111111111111111111111111111111111111111111111111111111111